ackley	Sarah Ackley
are	Elisha Are
beauclair	Roxanne Beauclair
bekele	Bewketu Bekele
bellan	Steve Bellan
bolton	Larisse Bolton
borchering	Rebecca Borchering
brook	Cara Brook
bruce	Faikah Bruce
brucePA	Faikah Bruce
delva	Wim Delva
dushoff	Jonathan Dushoff
ervin	Sara Ervin
faikah	Faikah Bruce
grebe	Eduard Grebe
hargrove	John Hargrove
hitchcock	Gavin Hitchcock
january	Rene January
kassanjee	Reshma Kassanjee
li	Michael Li
lord	Jennifer Lord
marx	Florian Marx
mcintosh	Avery McIntosh
mhlanga	Laurette Mhlanga
mthombothi	Zinhle Mthombothi
mugwagwa	Tendai Mugwagwa
mwangi	Thumbi Mwangi
mwebaze	Ernest Mwebaze
ndifon	Wilfred Ndifon
ngonghala	Calistus Ngonghala
nondi	Joseph Nondi
nyamai	Mutono Nyamai
october	Amanda October
paradza	Masimba Paradza
pearson	Carl Pearson
porco	Travis Porco
pulliam	Juliet Pulliam
reiner	Bobby Reiner
scheepers	Lynnemore Scheepers
scott	Jim Scott
sempa	Joseph Sempa
sikhondze	Welile Sikhondze
template	name:
ujeneza	Eva Ujeneza
vanschalkwyk	Cari van Schalkwyk
welte	Alex Welte
williams	Brian Williams
ying	Roger Ying

